Наименование алгоритмов из задач на слайдах

Семинар 1 -- основы языка C

Алгоритм E -- алгоритм Евклида
Алгоритм F -- числа Фибоначчи
Problem RL -- рекурсия в цикл (алгоритм Евклида)
Problem EE -- расширенный алгоритм E
Алгоритм POWM -- возведение в степень по модулю
Problem FD -- разряды чисел Фибоначчи
Problem FM -- вычисления по модулю m
Problem PP -- периоды Пизано
Problem SF -- система чисел Фибоначчи
Алгоритм FR -- рекурсивный алгоритм F
Problem MF -- matrix Fibonacci (optional)
Алгоритм FF -- Фибоначчи с плавающими числами
Домашнее задание HWF -- Фибоначиевый ним

Семинар 2 -- время и память

Problem LM -- lcm многих чисел
Алгоритм P -- является ли число простым
Problem PN -- N-ное простое число
Алгоритм S -- построение решета
Problem PN2 -- снова N-е простое
Problem GF -- генерирующие формулы
Problem PE -- побитовое решето
Problem FT -- тест Ферма
Problem PF -- Fibonacci primes
Домашняя работа HWE -- решето с признаком в каждом бите

Минимум о памяти -- стек, куча и глобальная память

Problem M1 -- исследование кучи
Problem M2 -- исследование стека

Семинар 3 -- массивы и указатели

Алгоритм L -- линейный поиск
Алгоритм B -- бинарный поиск
Problem ME -- поиск большинства
Problem MSB -- необычный поиск (most sign bit)
Problem MP -- перемножение полиномов
Алгоритм I -- сортировка вставками
Алгоритм SE -- сортировка выбором
Алгоритм Q -- быстрая сортировка
Problem UC -- поиск в массиве double
Problem CS -- обобщение alg SE
Problem CQ -- обобщение сортировки
Problem POW2 -- матрицы в степень
Домашняя работа HWS: Timsort (optional)

Семинар 4 -- строки и файлы

Problem SR -- переворот строки
Problem SU -- поиск подстроки
Домашняя работа HWK -- алгоритм КМП (optional)
Problem ED -- расстояние редактирования
Problem SP -- замена в строке
Problem EA -- вывести аргументы
Problem FO -- вывод файла на экран
Problem FO2 -- вывод бинарного файла на экран
Проблем FS -- поиск внутри файла
Проблем SF -- сортировка файла

Контест по глубокому и поверхностному копированию

Problem ED2 -- максимальная общая подпоследовательность
Problem AC -- исправление указателей в массиве структур
Problem DC -- глубокое копирование массива структур
Problem LA -- список из массива списков
Problem RV -- переворот массива структур

Допсеминар -- жадные алгоритмы

Problem EV -- чётные степени двойки
Problem EG -- египетские дроби
Problem IC -- расписание аудитории
Problem RU -- ларьки под общую крышу
Problem JA -- распределение работы
Problem PC -- покрытие точек отрезками
Problem FP -- организация утренника
Problem GT -- является ли граф деревом
Домашняя работа HWG -- алгоритм Краскала (optional)

Минимум о многомодульных программах

Problem TS -- площадь треугольников

Семинар 5 -- структуры данных

Problem CL -- циклический список в размене монет
Problem HL -- найти петлю в связном списке
Алгоритм FL -- алгоритм Флойда
Алгоритм FL2 -- алгоритм Брента
Problem HL2 -- длина петли в связном списке
Problem RG -- найти период ГПСЧ
Алгоритм RFL -- рекурсивный разворот списка
Problem LR -- развернуть список итеративно
Домашняя работа HWH -- частотный словарь
Алгоритм RK -- алгоритм Рабина-Карпа
Problem KC -- коллизии Рабина-Карпа
Problem XC -- интересная хеш-функция
Алгоритм IR -- рекурсивный обход дерева
Problem TT -- из обхода в дерево
Алгоритм RQ -- диапазон в дереве
Problem IS -- проверить поисковость

Дополнительно: Problem LI -- пересечение списков

Минимум про объединения и перечисления

Problem LX -- лексический анализ
Problem ST -- синтаксическое дерево

Семинар 6 -- вещественные числа

Problem PI -- генерация числа pi
Problem AQ -- быстрые приближённые функции
Problem RP -- представление плавающих чисел
Problem DH -- решение уравнений дихотомией
Алгоритм SС -- метод секущих
Problem EС -- сравнение количества итераций
Алгоритм N -- метод Ньютона
Problem EN -- решение методом Ньютона
Problem RI -- инверсный квадратный корень
Problem AN -- улучшение произведений

Минимум про препроцессор

Первая полусеместровая контрольная

OE, SM, GP, TD, PR

Семинар 7 -- ассемблер

Problem MK –- эмулятор калькулятора
Problem AS –- кодировщик калькулятора
Problem CM –- crackme #0
Problem KG –- keygen #0
Problem IA -- упражнение в инлайн ассемблере
Problem LG -- шпионская функция
Problem RA –- инверсный квадратный корень ассемблерной вставкой
Домашняя работа HWV - оптимизация бинарника

Введение в язык C

Семинар 8 -- язык C в реальном мире

Problem LC -- LRU кэш

Вторая полусеместровая контрольная

SS, TP, PM, SC, AI

Допсеминар -- OpenCL
