Наименование алгоритмов из задач на слайдах

Семинар 1 -- основы языка C

Алгоритм E -- алгоритм Евклида
Алгоритм F -- числа Фибоначчи
Problem RL -- рекурсия в цикл (алгоритм Евклида)
Алгоритм POWM -- возведение в степень по модулю
Problem FD -- разряды чисел Фибоначчи
Problem FM -- вычисления по модулю m
Problem PP -- периоды Пизано
Problem SF -- система чисел Фибоначчи
Алгоритм FR -- рекурсивный алгоритм F
Problem MF -- matrix Fibonacci (optional)
Алгоритм FF -- Фибоначчи с плавающими числами
Домашнее задание HWF -- Фибоначиевый ним

Семинар 2 -- время и память

Problem LM -- lcm многих чисел
Алгоритм P -- является ли число простым
Problem PN -- N-ное простое число
Алгоритм S -- построение решета
Problem PN2 -- снова N-е простое
Problem GF -- генерирующие формулы
Problem PE -- побитовое решето
Problem FT -- тест Ферма
Problem PF -- Fibonacci primes
Домашняя работа HWE -- решето с признаком в каждом бите

Семинар 3 -- массивы и указатели

Алгоритм L -- линейный поиск
Алгоритм B -- бинарный поиск
Problem ME -- поиск большинства
Problem MSB -- необычный поиск (most sign bit)
Problem MP -- перемножение полиномов
Алгоритм I -- сортировка вставками
Алгоритм SE -- сортировка выбором
Алгоритм Q -- быстрая сортировка
Problem UC -- поиск в массиве double
Problem CS -- обобщение alg SE
Problem CQ -- обобщение сортировки
Problem POW2 -- матрицы в степень
Домашняя работа HWS: Timsort (optional)

Семинар 4 -- строки и файлы

Problem SR -- переворот строки
Problem SU -- поиск подстроки
Домашняя работа HWK -- алгоритм КМП (optional)
Problem ED -- расстояние редактирования
Problem SP -- замена в строке
Problem EA -- вывести аргументы
Problem FO -- вывод файла на экран
Problem FO2 -- вывод бинарного файла на экран
Проблем FS -- поиск внутри файла
Проблем SF -- сортировка файла

Контест по глубокому и поверхностному копированию

Problem ED2 -- максимальная общая подпоследовательность
Problem AC -- исправление указателей в массиве структур
Problem DC -- глубокое копирование массива структур
Problem LA -- список из массива списков
Problem RV -- переворот массива структур
